5 10
|--------|
|.₢.|..-8|
|..-|.@..|
|.₢....-.|
|--------|